100 100 100 100 100 100 100 100 100 100 100 100 100 100 100 100 100 100 100 100 100 100 100 100 100 100 100 100 100 100 100 100 100 100 100 100 100 100 100 100 
100 100 100 100 100 100 100 100 100 100 100 100 100 100 100 100 100 100 100 100 100 100 100 100 100 100 100 100 100 100 100 100 100 100 100 100 100 100 100 100 
100 100 100 100 100 100 100 100 100 100 100 100 100 100 100 100 100 100 100 100 100 100 100 100 100 100 100 100 100 100 100 100 100 100 100 100 100 100 100 100 
100 100 100 100 100 100 100 100 100 100 100 100 100 100 100 100 100 100 100 100 100 100 100 100 100 100 100 100 100 100 100 100 100 100 100 100 100 100 100 100 
100 100 100 100 100 100 100 100 100 100 100 100 100 100 100 100 100 100 100 100 100 100 100 100 100 100 100 100 100 100 100 100 100 100 100 100 100 100 100 100 
100 100 100 100 100 100 100 100 100 100 100 100 100 100 100 100 100 100 100 100 100 100 100 100 100 100 100 100 100 100 100 100 100 100 100 100 100 100 100 100 
100 100 100 100 100 100 100 100 100 100 100 100 100 100 100 100 100 100 100 100 100 100 100 100 100 100 100 100 100 100 100 100 100 100 100 100 100 100 100 100 
100 100 100 100 100 100 100 100 100 100 100 100 100 100 100 100 100 100 100 100 100 100 100 100 100 100 100 100 100 100 100 100 100 100 100 100 100 100 100 100 
100 100 100 100 100 100 100 100 103 992 992 992 104 992 992 992 103 800 992 992 104 992 992 992 202 222 222 222 100 100 100 100 100 100 100 100 100 100 100 100 
100 100 100 100 100 100 100 100 992 992 992 992 992 992 992 992 992 992 992 992 992 992 992 992 222 222 222 222 100 100 100 100 100 100 100 100 100 100 100 100 
100 100 100 100 100 100 100 100 992 992 992 992 992 992 992 992 992 992 992 992 992 992 992 992 222 222 222 222 100 100 100 100 100 100 100 100 100 100 100 100 
100 100 100 100 100 100 100 100 992 992 992 992 992 992 992 992 992 992 992 992 992 992 992 992 222 222 222 222 100 100 100 100 100 100 100 100 100 100 100 100 
100 100 100 100 100 100 100 100 104 992 992 992 103 992 992 992 104 992 992 992 103 992 992 992 202 222 222 222 100 100 100 100 100 100 100 100 100 100 100 100 
100 100 100 100 100 100 100 100 992 992 992 992 992 992 992 992 992 992 992 992 992 992 992 992 222 222 222 222 100 100 100 100 100 100 100 100 100 100 100 100 
100 100 100 100 100 100 100 100 992 992 992 992 992 992 992 992 992 992 992 992 992 992 992 992 222 222 222 222 100 100 100 100 100 100 100 100 100 100 100 100 
100 100 100 100 100 100 100 100 992 992 992 992 992 992 992 992 992 992 992 992 992 992 992 992 222 222 222 222 100 100 100 100 100 100 100 100 100 100 100 100 
100 100 100 100 100 100 100 100 103 992 992 992 104 992 992 992 103 992 992 992 104 992 992 992 202 222 222 222 100 100 100 100 100 100 100 100 100 100 100 100 
100 100 100 100 100 100 100 100 992 992 992 992 992 992 992 992 992 992 992 992 992 992 992 992 222 222 222 222 100 100 100 100 100 100 100 100 100 100 100 100 
100 100 100 100 100 100 100 100 992 992 992 992 992 992 992 992 992 992 992 992 901 222 222 222 222 222 222 222 100 100 100 100 100 100 100 100 100 100 100 100 
100 100 100 100 100 100 100 100 992 992 992 992 992 992 992 992 992 992 992 992 222 222 222 222 222 222 222 222 100 100 100 100 100 100 100 100 100 100 100 100 
100 100 100 100 100 100 100 100 104 992 992 992 103 992 992 992 104 992 992 992 222 222 222 222 202 222 222 222 100 100 100 100 100 100 100 100 100 100 100 100 
100 100 100 100 100 100 100 100 992 992 992 992 992 992 992 992 992 992 992 992 222 222 222 222 222 222 222 222 100 100 100 100 100 100 100 100 100 100 100 100 
100 100 100 100 100 100 100 100 992 992 992 992 992 992 992 992 992 992 992 992 103 992 992 992 222 222 222 222 100 100 100 100 100 100 100 100 100 100 100 100 
100 100 100 100 100 100 100 100 992 992 992 992 992 992 992 992 992 992 992 992 992 992 992 992 222 222 222 222 100 100 100 100 100 100 100 100 100 100 100 100 
100 100 100 100 100 100 100 100 103 992 992 992 104 992 992 992 103 992 992 992 104 992 992 992 202 222 222 222 100 100 100 100 100 100 100 100 100 100 100 100 
100 100 100 100 100 100 100 100 992 992 992 992 992 992 992 992 992 992 992 992 992 992 992 992 222 222 222 222 100 100 100 100 100 100 100 100 100 100 100 100 
100 100 100 100 100 100 100 100 992 992 992 992 992 992 992 992 992 992 992 992 992 992 992 992 222 222 222 222 100 100 100 100 100 100 100 100 100 100 100 100 
100 100 100 100 100 100 100 100 992 992 992 992 992 992 992 992 992 992 992 992 992 992 992 992 222 222 222 222 100 100 100 100 100 100 100 100 100 100 100 100 
100 100 100 100 100 100 100 100 104 992 992 992 103 992 992 992 104 992 992 992 103 992 992 992 202 222 222 222 100 100 100 100 100 100 100 100 100 100 100 100 
100 100 100 100 100 100 100 100 992 992 992 992 992 992 992 992 992 992 992 992 992 992 992 992 222 222 222 222 100 100 100 100 100 100 100 100 100 100 100 100 
100 100 100 100 100 100 100 100 992 992 992 992 992 992 992 992 992 992 992 992 992 992 992 992 222 222 222 222 100 100 100 100 100 100 100 100 100 100 100 100 
100 100 100 100 100 100 100 100 992 992 992 992 992 992 992 992 992 992 992 992 992 992 992 992 222 222 222 222 100 100 100 100 100 100 100 100 100 100 100 100 
100 100 100 100 100 100 100 100 100 100 100 100 100 100 100 100 100 100 100 100 100 100 100 100 100 100 100 100 100 100 100 100 100 100 100 100 100 100 100 100 
100 100 100 100 100 100 100 100 100 100 100 100 100 100 100 100 100 100 100 100 100 100 100 100 100 100 100 100 100 100 100 100 100 100 100 100 100 100 100 100 
100 100 100 100 100 100 100 100 100 100 100 100 100 100 100 100 100 100 100 100 100 100 100 100 100 100 100 100 100 100 100 100 100 100 100 100 100 100 100 100 
100 100 100 100 100 100 100 100 100 100 100 100 100 100 100 100 100 100 100 100 100 100 100 100 100 100 100 100 100 100 100 100 100 100 100 100 100 100 100 100 
100 100 100 100 100 100 100 100 100 100 100 100 100 100 100 100 100 100 100 100 100 100 100 100 100 100 100 100 100 100 100 100 100 100 100 100 100 100 100 100 
100 100 100 100 100 100 100 100 100 100 100 100 100 100 100 100 100 100 100 100 100 100 100 100 100 100 100 100 100 100 100 100 100 100 100 100 100 100 100 100 
100 100 100 100 100 100 100 100 100 100 100 100 100 100 100 100 100 100 100 100 100 100 100 100 100 100 100 100 100 100 100 100 100 100 100 100 100 100 100 100 
100 100 100 100 100 100 100 100 100 100 100 100 100 100 100 100 100 100 100 100 100 100 100 100 100 100 100 100 100 100 100 100 100 100 100 100 100 100 100 100 
room2.txt
NONE
jukebox_room.txt
NONE
