100 100 100 100 100 100 100 100 100 100 100 100 100 100 100 100 100 100 100 100 100 100 100 100 100 100 100 100 100 100 100 100 100 100 100 100 100 100 100 100
100 100 100 100 100 100 100 100 100 100 100 100 100 100 100 100 100 100 100 100 100 100 100 100 100 100 100 100 100 100 100 100 100 100 100 100 100 100 100 100
100 100 100 100 100 100 100 100 100 100 100 100 100 100 100 100 100 100 100 100 100 100 100 100 100 100 100 100 100 100 100 100 100 100 100 100 100 100 100 100
100 100 100 100 100 100 100 100 100 100 100 100 100 100 100 100 100 100 100 100 100 100 100 100 100 100 100 100 100 100 100 100 100 100 100 100 100 100 100 100
100 100 100 100 100 100 100 100 100 100 100 100 100 100 100 100 100 100 100 100 100 100 100 100 100 100 100 100 100 100 100 100 100 100 100 100 100 100 100 100
100 100 100 100 100 100 100 100 100 100 100 100 100 100 100 100 100 100 100 100 100 100 100 100 100 100 100 100 100 100 100 100 100 100 100 100 100 100 100 100
100 100 100 100 100 100 100 100 100 100 100 100 100 100 100 100 100 100 100 100 100 100 100 100 100 100 100 100 100 100 100 100 100 100 100 100 100 100 100 100
100 100 100 100 100 100 100 100 100 100 100 100 100 100 100 100 100 100 100 100 100 100 100 100 100 100 100 100 100 100 100 100 100 100 100 100 100 100 100 100
100 100 100 100 100 100 100 100 102 102 102 102 101 101 101 101 102 102 102 102 101 101 101 101 202 202 202 202 100 100 100 100 100 100 100 100 100 100 100 100
100 100 100 100 100 100 100 100 102 102 102 102 101 101 101 101 102 800 999 102 101 101 101 101 202 202 202 202 100 100 100 100 100 100 100 100 100 100 100 100
100 100 100 100 100 100 100 100 102 102 102 102 101 101 101 101 102 999 999 102 101 101 101 101 202 202 202 202 100 100 100 100 100 100 100 100 100 100 100 100
100 100 100 100 100 100 100 100 102 102 102 102 101 101 101 101 102 102 102 102 101 101 101 101 202 202 202 202 100 100 100 100 100 100 100 100 100 100 100 100
100 100 100 100 100 100 100 100 101 101 101 101 102 102 102 102 101 101 101 101 102 102 102 102 202 202 202 202 100 100 100 100 100 100 100 100 100 100 100 100
100 100 100 100 100 100 100 100 101 101 101 101 102 102 102 102 101 101 101 101 102 102 102 102 202 202 202 202 100 100 100 100 100 100 100 100 100 100 100 100
100 100 100 100 100 100 100 100 101 101 101 101 102 102 102 102 101 101 101 101 102 102 102 102 202 202 202 202 100 100 100 100 100 100 100 100 100 100 100 100
100 100 100 100 100 100 100 100 101 101 101 101 102 102 102 102 101 101 101 101 102 102 102 102 202 202 202 202 100 100 100 100 100 100 100 100 100 100 100 100
100 100 100 100 100 100 100 100 102 102 102 102 101 101 101 101 102 102 102 102 101 101 101 101 202 202 202 202 100 100 100 100 100 100 100 100 100 100 100 100
100 100 100 100 100 100 100 100 102 102 102 102 101 101 101 101 102 102 102 102 101 101 101 101 202 202 202 202 100 100 100 100 100 100 100 100 100 100 100 100
100 100 100 100 100 100 100 100 102 102 102 102 101 101 101 101 102 102 102 102 901 999 999 999 202 202 202 202 100 100 100 100 100 100 100 100 100 100 100 100
100 100 100 100 100 100 100 100 102 102 102 102 101 101 101 101 102 102 102 102 999 999 999 999 202 202 202 202 100 100 100 100 100 100 100 100 100 100 100 100
100 100 100 100 100 100 100 100 101 101 101 101 102 102 102 102 101 101 101 101 999 999 999 999 202 202 202 202 100 100 100 100 100 100 100 100 100 100 100 100
100 100 100 100 100 100 100 100 101 101 101 101 102 102 102 102 101 101 101 101 999 999 999 999 202 202 202 202 100 100 100 100 100 100 100 100 100 100 100 100
100 100 100 100 100 100 100 100 101 101 101 101 102 102 102 102 101 101 101 101 102 102 102 102 202 202 202 202 100 100 100 100 100 100 100 100 100 100 100 100
100 100 100 100 100 100 100 100 101 101 101 101 102 102 102 102 101 101 101 101 102 102 102 102 202 202 202 202 100 100 100 100 100 100 100 100 100 100 100 100
100 100 100 100 100 100 100 100 102 102 102 102 101 101 101 101 102 102 102 102 101 101 101 101 202 202 202 202 100 100 100 100 100 100 100 100 100 100 100 100
100 100 100 100 100 100 100 100 102 102 102 102 101 101 101 101 102 102 102 102 101 101 101 101 202 202 202 202 100 100 100 100 100 100 100 100 100 100 100 100
100 100 100 100 100 100 100 100 102 102 102 102 101 101 101 101 102 102 102 102 101 101 101 101 202 202 202 202 100 100 100 100 100 100 100 100 100 100 100 100
100 100 100 100 100 100 100 100 102 102 102 102 101 101 101 101 102 102 102 102 101 101 101 101 202 202 202 202 100 100 100 100 100 100 100 100 100 100 100 100
100 100 100 100 100 100 100 100 101 101 101 101 102 102 102 102 101 101 101 101 102 102 102 102 202 202 202 202 100 100 100 100 100 100 100 100 100 100 100 100
100 100 100 100 100 100 100 100 101 101 101 101 102 102 102 102 101 101 101 101 102 102 102 102 202 202 202 202 100 100 100 100 100 100 100 100 100 100 100 100
100 100 100 100 100 100 100 100 101 101 101 101 102 102 102 102 101 101 101 101 102 102 102 102 202 202 202 202 100 100 100 100 100 100 100 100 100 100 100 100
100 100 100 100 100 100 100 100 101 101 101 101 102 102 102 102 101 101 101 101 102 102 102 102 202 202 202 202 100 100 100 100 100 100 100 100 100 100 100 100
100 100 100 100 100 100 100 100 100 100 100 100 100 100 100 100 100 100 100 100 100 100 100 100 100 100 100 100 100 100 100 100 100 100 100 100 100 100 100 100
100 100 100 100 100 100 100 100 100 100 100 100 100 100 100 100 100 100 100 100 100 100 100 100 100 100 100 100 100 100 100 100 100 100 100 100 100 100 100 100
100 100 100 100 100 100 100 100 100 100 100 100 100 100 100 100 100 100 100 100 100 100 100 100 100 100 100 100 100 100 100 100 100 100 100 100 100 100 100 100
100 100 100 100 100 100 100 100 100 100 100 100 100 100 100 100 100 100 100 100 100 100 100 100 100 100 100 100 100 100 100 100 100 100 100 100 100 100 100 100
100 100 100 100 100 100 100 100 100 100 100 100 100 100 100 100 100 100 100 100 100 100 100 100 100 100 100 100 100 100 100 100 100 100 100 100 100 100 100 100
100 100 100 100 100 100 100 100 100 100 100 100 100 100 100 100 100 100 100 100 100 100 100 100 100 100 100 100 100 100 100 100 100 100 100 100 100 100 100 100
100 100 100 100 100 100 100 100 100 100 100 100 100 100 100 100 100 100 100 100 100 100 100 100 100 100 100 100 100 100 100 100 100 100 100 100 100 100 100 100
100 100 100 100 100 100 100 100 100 100 100 100 100 100 100 100 100 100 100 100 100 100 100 100 100 100 100 100 100 100 100 100 100 100 100 100 100 100 100 100
NONE 
NONE
NONE
NONE
