100 100 100 100 100 100 100 100 100 100 100 100 100 100 100 100 100 100 100 100 100 100 100 100 100 100 100 100 100 100 100 100 100 100 100 100 100 100 100 100 
100 100 100 100 100 100 100 100 100 100 100 100 100 100 100 100 100 100 100 100 100 100 100 100 100 100 100 100 100 100 100 100 100 100 100 100 100 100 100 100 
100 100 100 100 100 100 100 100 100 100 100 100 100 100 100 100 100 100 100 100 100 100 100 100 100 100 100 100 100 100 100 100 100 100 100 100 100 100 100 100 
100 100 100 100 100 100 100 100 100 100 100 100 100 100 100 100 100 100 100 100 100 100 100 100 100 100 100 100 100 100 100 100 100 100 100 100 100 100 100 100 
100 100 100 100 100 100 100 100 100 100 100 100 100 100 100 100 100 100 100 100 100 100 100 100 100 100 100 100 100 100 100 100 100 100 100 100 100 100 100 100 
100 100 100 100 100 100 100 100 100 100 100 100 100 100 100 100 100 100 100 100 100 100 100 100 100 100 100 100 100 100 100 100 100 100 100 100 100 100 100 100 
100 100 100 100 100 100 100 100 100 100 100 100 100 100 100 100 100 100 100 100 100 100 100 100 100 100 100 100 100 100 100 100 100 100 100 100 100 100 100 100 
100 100 100 100 100 100 100 100 100 100 100 100 100 100 100 100 100 100 100 100 100 100 100 100 100 100 100 100 100 100 100 100 100 100 100 100 100 100 100 100 
100 100 100 100 100 100 100 100 103 999 999 999 104 999 999 999 103 800 999 999 104 999 999 999 344 222 222 222 100 100 100 100 100 100 100 100 100 100 100 100 
100 100 100 100 100 100 100 100 999 999 999 999 999 999 999 999 999 999 999 999 999 999 999 999 222 222 222 222 100 100 100 100 100 100 100 100 100 100 100 100 
100 100 100 100 100 100 100 100 999 999 999 999 999 999 999 999 999 999 999 999 999 999 999 999 222 222 222 222 100 100 100 100 100 100 100 100 100 100 100 100 
100 100 100 100 100 100 100 100 999 999 999 999 999 999 999 999 999 999 999 999 999 999 999 999 222 222 222 222 100 100 100 100 100 100 100 100 100 100 100 100 
100 100 100 100 100 100 100 100 104 999 999 999 103 999 999 999 104 999 999 999 103 999 999 999 344 222 222 222 100 100 100 100 100 100 100 100 100 100 100 100 
100 100 100 100 100 100 100 100 999 999 999 999 999 999 999 999 999 999 999 999 999 999 999 999 222 222 222 222 100 100 100 100 100 100 100 100 100 100 100 100 
100 100 100 100 100 100 100 100 999 999 999 999 999 999 999 999 999 999 999 999 999 999 999 999 222 222 222 222 100 100 100 100 100 100 100 100 100 100 100 100 
100 100 100 100 100 100 100 100 999 999 999 999 999 999 999 999 999 999 999 999 999 999 999 999 222 222 222 222 100 100 100 100 100 100 100 100 100 100 100 100 
100 100 100 100 100 100 100 100 103 999 999 999 104 999 999 999 103 999 999 999 104 999 999 999 344 222 222 222 100 100 100 100 100 100 100 100 100 100 100 100 
100 100 100 100 100 100 100 100 999 999 999 999 999 999 999 999 999 999 999 999 999 999 999 999 222 222 222 222 100 100 100 100 100 100 100 100 100 100 100 100 
100 100 100 100 100 100 100 100 999 999 999 999 999 999 999 999 999 999 999 999 901 222 222 222 222 222 222 222 100 100 100 100 100 100 100 100 100 100 100 100 
100 100 100 100 100 100 100 100 999 999 999 999 999 999 999 999 999 999 999 999 222 222 222 222 222 222 222 222 100 100 100 100 100 100 100 100 100 100 100 100 
100 100 100 100 100 100 100 100 104 999 999 999 103 999 999 999 104 999 999 999 222 222 222 222 344 222 222 222 100 100 100 100 100 100 100 100 100 100 100 100 
100 100 100 100 100 100 100 100 999 999 999 999 999 999 999 999 999 999 999 999 222 222 222 222 222 222 222 222 100 100 100 100 100 100 100 100 100 100 100 100 
100 100 100 100 100 100 100 100 999 999 999 999 999 999 999 999 999 999 999 999 103 999 999 999 222 222 222 222 100 100 100 100 100 100 100 100 100 100 100 100 
100 100 100 100 100 100 100 100 999 999 999 999 999 999 999 999 999 999 999 999 999 999 999 999 222 222 222 222 100 100 100 100 100 100 100 100 100 100 100 100 
100 100 100 100 100 100 100 100 103 999 999 999 104 999 999 999 103 999 999 999 104 999 999 999 344 222 222 222 100 100 100 100 100 100 100 100 100 100 100 100 
100 100 100 100 100 100 100 100 999 999 999 999 999 999 999 999 999 999 999 999 999 999 999 999 222 222 222 222 100 100 100 100 100 100 100 100 100 100 100 100 
100 100 100 100 100 100 100 100 999 999 999 999 999 999 999 999 999 999 999 999 999 999 999 999 222 222 222 222 100 100 100 100 100 100 100 100 100 100 100 100 
100 100 100 100 100 100 100 100 999 999 999 999 999 999 999 999 999 999 999 999 999 999 999 999 222 222 222 222 100 100 100 100 100 100 100 100 100 100 100 100 
100 100 100 100 100 100 100 100 104 999 999 999 103 999 999 999 104 999 999 999 103 999 999 999 344 222 222 222 100 100 100 100 100 100 100 100 100 100 100 100 
100 100 100 100 100 100 100 100 999 999 999 999 999 999 999 999 999 999 999 999 999 999 999 999 222 222 222 222 100 100 100 100 100 100 100 100 100 100 100 100 
100 100 100 100 100 100 100 100 999 999 999 999 999 999 999 999 999 999 999 999 999 999 999 999 222 222 222 222 100 100 100 100 100 100 100 100 100 100 100 100 
100 100 100 100 100 100 100 100 999 999 999 999 999 999 999 999 999 999 999 999 999 999 999 999 222 222 222 222 100 100 100 100 100 100 100 100 100 100 100 100 
100 100 100 100 100 100 100 100 100 100 100 100 100 100 100 100 100 100 100 100 100 100 100 100 100 100 100 100 100 100 100 100 100 100 100 100 100 100 100 100 
100 100 100 100 100 100 100 100 100 100 100 100 100 100 100 100 100 100 100 100 100 100 100 100 100 100 100 100 100 100 100 100 100 100 100 100 100 100 100 100 
100 100 100 100 100 100 100 100 100 100 100 100 100 100 100 100 100 100 100 100 100 100 100 100 100 100 100 100 100 100 100 100 100 100 100 100 100 100 100 100 
100 100 100 100 100 100 100 100 100 100 100 100 100 100 100 100 100 100 100 100 100 100 100 100 100 100 100 100 100 100 100 100 100 100 100 100 100 100 100 100 
100 100 100 100 100 100 100 100 100 100 100 100 100 100 100 100 100 100 100 100 100 100 100 100 100 100 100 100 100 100 100 100 100 100 100 100 100 100 100 100 
100 100 100 100 100 100 100 100 100 100 100 100 100 100 100 100 100 100 100 100 100 100 100 100 100 100 100 100 100 100 100 100 100 100 100 100 100 100 100 100 
100 100 100 100 100 100 100 100 100 100 100 100 100 100 100 100 100 100 100 100 100 100 100 100 100 100 100 100 100 100 100 100 100 100 100 100 100 100 100 100 
100 100 100 100 100 100 100 100 100 100 100 100 100 100 100 100 100 100 100 100 100 100 100 100 100 100 100 100 100 100 100 100 100 100 100 100 100 100 100 100 
room1.txt
none
none
none
