100 100 100 100 100 100 100 100 100 100 100 100 100 100 100 100 100 100 100 100 100 100 100 100 100 100 100 100 100 100 100 100 100 100 100 100 100 100 100 100 
100 100 100 100 100 100 100 100 100 100 100 100 100 100 100 100 100 100 100 100 100 100 100 100 100 100 100 100 100 100 100 100 100 100 100 100 100 100 100 100 
100 100 100 100 100 100 100 100 100 100 100 100 100 100 100 100 100 100 100 100 100 100 100 100 100 100 100 100 100 100 100 100 100 100 100 100 100 100 100 100 
100 100 100 100 100 100 100 100 100 100 100 100 100 100 100 100 100 100 100 100 100 100 100 100 100 100 100 100 100 100 100 100 100 100 100 100 100 100 100 100 
100 100 100 100 100 100 100 100 100 100 100 100 100 100 100 100 100 100 100 100 100 100 100 100 100 100 100 100 100 100 100 100 100 100 100 100 100 100 100 100 
100 100 100 100 100 100 100 100 100 100 100 100 100 100 100 100 100 100 100 100 100 100 100 100 100 100 100 100 100 100 100 100 100 100 100 100 100 100 100 100 
100 100 100 100 100 100 100 100 100 100 100 100 100 100 100 100 100 100 100 100 100 100 100 100 100 100 100 100 100 100 100 100 100 100 100 100 100 100 100 100 
100 100 100 100 100 100 100 100 100 100 100 100 100 100 100 100 100 100 100 100 100 100 100 100 100 100 100 100 100 100 100 100 100 100 100 100 100 100 100 100 
100 100 100 100 100 100 100 100 103 991 991 991 104 991 991 991 103 800 991 991 104 991 991 991 202 991 991 991 100 100 100 100 100 100 100 100 100 100 100 100 
100 100 100 100 100 100 100 100 991 991 991 991 991 991 991 991 991 991 991 991 991 991 991 991 991 991 991 991 100 100 100 100 100 100 100 100 100 100 100 100 
100 100 100 100 100 100 100 100 991 991 991 991 991 991 991 991 991 991 991 991 991 991 991 991 991 991 991 991 100 100 100 100 100 100 100 100 100 100 100 100 
100 100 100 100 100 100 100 100 991 991 991 991 991 991 991 991 991 991 991 991 991 991 991 991 991 991 991 991 100 100 100 100 100 100 100 100 100 100 100 100 
100 100 100 100 100 100 100 100 104 991 991 991 103 991 991 991 104 991 991 991 103 991 991 991 202 991 991 991 100 100 100 100 100 100 100 100 100 100 100 100 
100 100 100 100 100 100 100 100 991 991 991 991 991 991 991 991 991 991 991 991 991 991 991 991 991 991 991 991 100 100 100 100 100 100 100 100 100 100 100 100 
100 100 100 100 100 100 100 100 991 991 991 991 991 991 991 991 991 991 991 991 991 991 991 991 991 991 991 991 100 100 100 100 100 100 100 100 100 100 100 100 
100 100 100 100 100 100 100 100 991 991 991 991 991 991 991 991 991 991 991 991 991 991 991 991 991 991 991 991 100 100 100 100 100 100 100 100 100 100 100 100 
100 100 100 100 100 100 100 100 103 991 991 991 104 991 991 991 103 991 991 991 104 991 991 991 202 991 991 991 100 100 100 100 100 100 100 100 100 100 100 100 
100 100 100 100 100 100 100 100 991 991 991 991 991 991 991 991 991 991 991 991 991 991 991 991 991 991 991 991 100 100 100 100 100 100 100 100 100 100 100 100 
100 100 100 100 100 100 100 100 991 991 991 991 991 991 991 991 991 991 991 991 902 991 991 991 991 991 991 991 100 100 100 100 100 100 100 100 100 100 100 100 
100 100 100 100 100 100 100 100 991 991 991 991 991 991 991 991 991 991 991 991 991 991 991 991 991 991 991 991 100 100 100 100 100 100 100 100 100 100 100 100 
100 100 100 100 100 100 100 100 104 991 991 991 103 991 991 991 104 991 991 991 991 991 991 991 202 991 991 991 100 100 100 100 100 100 100 100 100 100 100 100 
100 100 100 100 100 100 100 100 991 991 991 991 991 991 991 991 991 991 991 991 991 991 991 991 991 991 991 991 100 100 100 100 100 100 100 100 100 100 100 100 
100 100 100 100 100 100 100 100 991 991 991 991 991 991 991 991 991 991 991 991 103 991 991 991 991 991 991 991 100 100 100 100 100 100 100 100 100 100 100 100 
100 100 100 100 100 100 100 100 991 991 991 991 991 991 991 991 991 991 991 991 991 991 991 991 991 991 991 991 100 100 100 100 100 100 100 100 100 100 100 100 
100 100 100 100 100 100 100 100 103 991 991 991 104 991 991 991 103 991 991 991 104 991 991 991 202 991 991 991 100 100 100 100 100 100 100 100 100 100 100 100 
100 100 100 100 100 100 100 100 991 991 991 991 991 991 991 991 991 991 991 991 991 991 991 991 991 991 991 991 100 100 100 100 100 100 100 100 100 100 100 100 
100 100 100 100 100 100 100 100 991 991 991 991 991 991 991 991 991 991 991 991 991 991 991 991 991 991 991 991 100 100 100 100 100 100 100 100 100 100 100 100 
100 100 100 100 100 100 100 100 991 991 991 991 991 991 991 991 991 991 991 991 991 991 991 991 991 991 991 991 100 100 100 100 100 100 100 100 100 100 100 100 
100 100 100 100 100 100 100 100 104 991 991 991 103 991 991 991 104 991 991 991 103 991 991 991 202 991 991 991 100 100 100 100 100 100 100 100 100 100 100 100 
100 100 100 100 100 100 100 100 991 991 991 991 991 991 991 991 991 991 991 991 991 991 991 991 991 991 991 991 100 100 100 100 100 100 100 100 100 100 100 100 
100 100 100 100 100 100 100 100 991 991 991 991 991 991 991 991 991 991 991 991 991 991 991 991 991 991 991 991 100 100 100 100 100 100 100 100 100 100 100 100 
100 100 100 100 100 100 100 100 991 991 991 991 991 991 991 991 991 991 991 991 991 991 991 991 991 991 991 991 100 100 100 100 100 100 100 100 100 100 100 100 
100 100 100 100 100 100 100 100 100 100 100 100 100 100 100 100 100 100 100 100 100 100 100 100 100 100 100 100 100 100 100 100 100 100 100 100 100 100 100 100 
100 100 100 100 100 100 100 100 100 100 100 100 100 100 100 100 100 100 100 100 100 100 100 100 100 100 100 100 100 100 100 100 100 100 100 100 100 100 100 100 
100 100 100 100 100 100 100 100 100 100 100 100 100 100 100 100 100 100 100 100 100 100 100 100 100 100 100 100 100 100 100 100 100 100 100 100 100 100 100 100 
100 100 100 100 100 100 100 100 100 100 100 100 100 100 100 100 100 100 100 100 100 100 100 100 100 100 100 100 100 100 100 100 100 100 100 100 100 100 100 100 
100 100 100 100 100 100 100 100 100 100 100 100 100 100 100 100 100 100 100 100 100 100 100 100 100 100 100 100 100 100 100 100 100 100 100 100 100 100 100 100 
100 100 100 100 100 100 100 100 100 100 100 100 100 100 100 100 100 100 100 100 100 100 100 100 100 100 100 100 100 100 100 100 100 100 100 100 100 100 100 100 
100 100 100 100 100 100 100 100 100 100 100 100 100 100 100 100 100 100 100 100 100 100 100 100 100 100 100 100 100 100 100 100 100 100 100 100 100 100 100 100 
100 100 100 100 100 100 100 100 100 100 100 100 100 100 100 100 100 100 100 100 100 100 100 100 100 100 100 100 100 100 100 100 100 100 100 100 100 100 100 100 
room1.txt
NONE
NONE
NONE
