100 100 100 100 100 100 100 100 100 100 100 100 100 100 100 100 100 100 100 100 100 100 100 100 100 100 100 100 100 100 100 100 100 100 100 100 100 100 100 100
100 100 100 100 100 100 100 100 100 100 100 100 100 100 100 100 100 100 100 100 100 100 100 100 100 100 100 100 100 100 100 100 100 100 100 100 100 100 100 100
100 100 100 100 100 100 100 100 100 100 100 100 100 100 100 100 100 100 100 100 100 100 100 100 100 100 100 100 100 100 100 100 100 100 100 100 100 100 100 100
100 100 100 100 100 100 100 100 100 100 100 100 100 100 100 100 100 100 100 100 100 100 100 100 100 100 100 100 100 100 100 100 100 100 100 100 100 100 100 100
100 100 100 100 100 100 100 100 100 100 100 100 100 100 100 100 100 100 100 100 100 100 100 100 100 100 100 100 100 100 100 100 100 100 100 100 100 100 100 100
100 100 100 100 100 100 100 100 100 100 100 100 100 100 100 100 100 100 100 100 100 100 100 100 100 100 100 100 100 100 100 100 100 100 100 100 100 100 100 100
100 100 100 100 100 100 100 100 100 100 100 100 100 100 100 100 100 100 100 100 100 100 100 100 100 100 100 100 100 100 100 100 100 100 100 100 100 100 100 100
100 100 100 100 100 100 100 100 100 100 100 100 100 100 100 100 100 100 100 100 100 100 100 100 100 100 100 100 100 100 100 100 100 100 100 100 100 100 100 100
100 100 100 100 100 100 100 100 103 999 999 999 104 999 999 999 103 999 999 999 104 999 999 999 202 999 999 999 100 100 100 100 100 100 100 100 100 100 100 100
100 100 100 100 100 100 100 100 999 999 999 999 999 999 999 999 999 800 999 999 999 999 999 999 999 999 999 999 100 100 100 100 100 100 100 100 100 100 100 100
100 100 100 100 100 100 100 100 999 999 999 999 999 999 999 999 999 999 999 999 999 999 999 999 999 999 999 999 100 100 100 100 100 100 100 100 100 100 100 100
100 100 100 100 100 100 100 100 999 999 999 999 999 999 999 999 999 999 999 999 999 999 999 999 999 999 999 999 100 100 100 100 100 100 100 100 100 100 100 100
100 100 100 100 100 100 100 100 104 999 999 999 103 999 999 999 104 999 999 999 103 999 999 999 202 999 999 999 100 100 100 100 100 100 100 100 100 100 100 100
100 100 100 100 100 100 100 100 999 999 999 999 999 999 999 999 999 999 999 999 999 999 999 999 999 999 999 999 100 100 100 100 100 100 100 100 100 100 100 100
100 100 100 100 100 100 100 100 999 999 999 999 999 999 999 999 999 999 999 999 999 999 999 999 999 999 999 999 100 100 100 100 100 100 100 100 100 100 100 100
100 100 100 100 100 100 100 100 999 999 999 999 999 999 999 999 999 999 999 999 999 999 999 999 999 999 999 999 100 100 100 100 100 100 100 100 100 100 100 100
100 100 100 100 100 100 100 100 103 999 999 999 104 999 999 999 103 999 999 999 104 999 999 999 202 999 999 999 100 100 100 100 100 100 100 100 100 100 100 100
100 100 100 100 100 100 100 100 999 999 999 999 999 999 999 999 999 999 999 999 999 999 999 999 999 999 999 999 100 100 100 100 100 100 100 100 100 100 100 100
100 100 100 100 100 100 100 100 999 999 999 999 999 999 999 999 999 999 999 999 901 999 999 999 999 999 999 999 100 100 100 100 100 100 100 100 100 100 100 100
100 100 100 100 100 100 100 100 999 999 999 999 999 999 999 999 999 999 999 999 999 999 999 999 999 999 999 999 100 100 100 100 100 100 100 100 100 100 100 100
100 100 100 100 100 100 100 100 104 999 999 999 103 999 999 999 104 999 999 999 999 999 999 999 202 999 999 999 100 100 100 100 100 100 100 100 100 100 100 100
100 100 100 100 100 100 100 100 999 999 999 999 999 999 999 999 999 999 999 999 999 999 999 999 999 999 999 999 100 100 100 100 100 100 100 100 100 100 100 100
100 100 100 100 100 100 100 100 999 999 999 999 999 999 999 999 999 999 999 999 103 999 999 999 999 999 999 999 100 100 100 100 100 100 100 100 100 100 100 100
100 100 100 100 100 100 100 100 999 999 999 999 999 999 999 999 999 999 999 999 999 999 999 999 999 999 999 999 100 100 100 100 100 100 100 100 100 100 100 100
100 100 100 100 100 100 100 100 103 999 999 999 104 999 999 999 103 999 999 999 104 999 999 999 202 999 999 999 100 100 100 100 100 100 100 100 100 100 100 100
100 100 100 100 100 100 100 100 999 999 999 999 999 999 999 999 999 999 999 999 999 999 999 999 999 999 999 999 100 100 100 100 100 100 100 100 100 100 100 100
100 100 100 100 100 100 100 100 999 999 999 999 999 999 999 999 999 999 999 999 999 999 999 999 999 999 999 999 100 100 100 100 100 100 100 100 100 100 100 100
100 100 100 100 100 100 100 100 999 999 999 999 999 999 999 999 999 999 999 999 999 999 999 999 999 999 999 999 100 100 100 100 100 100 100 100 100 100 100 100
100 100 100 100 100 100 100 100 104 999 999 999 103 999 999 999 104 999 999 999 103 999 999 999 202 999 999 999 100 100 100 100 100 100 100 100 100 100 100 100
100 100 100 100 100 100 100 100 999 999 999 999 999 999 999 999 999 999 999 999 999 999 999 999 999 999 999 999 100 100 100 100 100 100 100 100 100 100 100 100
100 100 100 100 100 100 100 100 999 999 999 999 999 999 999 999 999 999 999 999 999 999 999 999 999 999 999 999 100 100 100 100 100 100 100 100 100 100 100 100
100 100 100 100 100 100 100 100 999 999 999 999 999 999 999 999 999 999 999 999 999 999 999 999 999 999 999 999 100 100 100 100 100 100 100 100 100 100 100 100
100 100 100 100 100 100 100 100 100 100 100 100 100 100 100 100 100 100 100 100 100 100 100 100 100 100 100 100 100 100 100 100 100 100 100 100 100 100 100 100
100 100 100 100 100 100 100 100 100 100 100 100 100 100 100 100 100 100 100 100 100 100 100 100 100 100 100 100 100 100 100 100 100 100 100 100 100 100 100 100
100 100 100 100 100 100 100 100 100 100 100 100 100 100 100 100 100 100 100 100 100 100 100 100 100 100 100 100 100 100 100 100 100 100 100 100 100 100 100 100
100 100 100 100 100 100 100 100 100 100 100 100 100 100 100 100 100 100 100 100 100 100 100 100 100 100 100 100 100 100 100 100 100 100 100 100 100 100 100 100
100 100 100 100 100 100 100 100 100 100 100 100 100 100 100 100 100 100 100 100 100 100 100 100 100 100 100 100 100 100 100 100 100 100 100 100 100 100 100 100
100 100 100 100 100 100 100 100 100 100 100 100 100 100 100 100 100 100 100 100 100 100 100 100 100 100 100 100 100 100 100 100 100 100 100 100 100 100 100 100
100 100 100 100 100 100 100 100 100 100 100 100 100 100 100 100 100 100 100 100 100 100 100 100 100 100 100 100 100 100 100 100 100 100 100 100 100 100 100 100
100 100 100 100 100 100 100 100 100 100 100 100 100 100 100 100 100 100 100 100 100 100 100 100 100 100 100 100 100 100 100 100 100 100 100 100 100 100 100 100
NONE 
NONE
NONE
NONE
