100 100 100 100 100 100 100 100 100 100 100 100 100 100 100 100 100 100 100 100 100 100 100 100 100 100 100 100 100 100 100 100 100 100 100 100 100 100 100 100
100 100 100 100 100 100 100 100 100 100 100 100 100 100 100 100 100 100 100 100 100 100 100 100 100 100 100 100 100 100 100 100 100 100 100 100 100 100 100 100
100 100 100 100 100 100 100 100 100 100 100 100 100 100 100 100 100 106 999 999 999 100 100 100 100 100 100 100 100 100 100 100 100 100 100 100 100 100 100 100
100 100 100 100 100 100 100 100 100 100 100 100 100 100 100 100 100 999 800 999 999 100 100 100 100 100 100 100 100 100 100 100 100 100 100 100 100 100 100 100
100 100 100 100 100 100 100 100 100 100 100 100 100 100 100 100 100 999 999 999 999 100 100 100 100 100 100 100 100 100 100 100 100 100 100 100 100 100 100 100
100 100 100 100 100 100 100 100 100 100 100 100 100 100 100 100 100 999 999 999 999 100 100 100 100 100 100 100 100 100 100 100 100 100 100 100 100 100 100 100
100 100 100 100 100 100 100 100 100 100 100 100 100 100 100 100 100 4401 999 999 999 100 100 100 100 100 100 100 100 100 100 100 100 100 100 100 100 100 100 100
100 100 100 100 100 100 100 100 100 100 100 100 100 100 100 100 100 4001 999 999 999 100 100 100 100 100 100 100 100 100 100 100 100 100 100 100 100 100 100 100
100 100 100 100 100 100 100 100 100 100 100 100 100 100 100 100 100 4101 999 999 999 100 100 100 100 100 100 100 100 100 100 100 100 100 100 100 100 100 100 100
100 100 100 100 100 100 100 100 100 100 100 100 100 100 100 100 100 4301 999 999 999 100 100 100 100 100 100 100 100 100 100 100 100 100 100 100 100 100 100 100
100 100 100 100 100 100 100 107 999 999 999 999 999 999 999 4310 106 999 999 106 999 999 4311 107 999 999 999 999 999 999 999 100 100 100 100 100 100 100 100 100
100 100 100 100 100 100 100 999 999 999 999 999 999 999 999 999 999 999 999 999 999 999 999 999 999 999 999 999 999 999 999 100 100 100 100 100 100 100 100 100
100 100 100 100 100 100 100 999 999 5000 999 999 999 999 999 999 999 999 999 999 999 999 999 999 999 5300 999 999 999 999 999 100 100 100 100 100 100 100 100 100
100 100 100 100 100 100 100 999 999 999 999 999 999 999 999 999 999 999 999 999 999 999 999 999 999 999 999 999 999 999 999 100 100 100 100 100 100 100 100 100
100 100 100 100 100 100 100 999 999 999 999 999 999 999 999 100 100 100 100 100 100 100 100 999 999 999 999 999 999 999 999 100 100 100 100 100 100 100 100 100
100 100 100 100 100 100 100 999 999 999 999 999 999 999 999 100 100 100 100 100 100 100 100 999 999 999 999 999 999 999 999 100 100 100 100 100 100 100 100 100
100 100 100 100 100 100 100 999 999 999 999 999 999 999 999 100 100 100 100 100 100 100 100 999 999 999 999 999 999 999 999 100 100 100 100 100 100 100 100 100
100 100 100 100 100 100 100 999 999 999 999 999 999 999 999 100 100 100 100 100 100 100 100 999 999 999 999 999 999 999 999 100 100 100 100 100 100 100 100 100
100 100 100 100 100 100 100 107 999 999 999 999 999 999 999 100 100 100 100 100 100 100 100 107 999 999 999 999 999 999 999 100 100 100 100 100 100 100 100 100
100 100 100 100 100 100 100 999 999 999 999 999 999 999 999 100 100 100 100 100 100 100 100 999 999 999 999 999 999 999 999 100 100 100 100 100 100 100 100 100
100 100 100 100 100 100 100 324 999 999 999 4301 999 999 999 100 100 100 100 100 100 100 100 4300 999 999 999 324 999 999 999 100 100 100 100 100 100 100 100 100
100 100 100 100 100 100 100 999 999 999 999 4001 999 999 999 100 100 100 100 100 100 100 100 4001 999 999 999 999 999 999 999 100 100 100 100 100 100 100 100 100
100 100 100 100 100 100 100 999 999 999 999 5400 999 999 999 5300 999 999 999 5100 999 999 999 5000 999 999 999 999 999 999 999 100 100 100 100 100 100 100 100 100
100 100 100 100 100 100 100 999 999 999 999 999 999 999 999 106 999 999 999 106 999 999 999 999 999 999 999 999 999 999 999 100 100 100 100 100 100 100 100 100
100 100 100 100 100 100 100 999 999 999 999 999 999 999 999 999 999 999 999 999 999 999 999 999 999 999 999 999 999 999 999 100 100 100 100 100 100 100 100 100
100 100 100 100 100 100 100 999 999 999 999 999 999 999 999 999 999 999 999 999 999 999 999 999 999 999 999 999 999 999 999 100 100 100 100 100 100 100 100 100
100 100 100 100 100 100 100 107 999 999 999 999 999 999 999 107 999 999 999 999 999 999 999 107 999 999 999 999 999 999 999 100 100 100 100 100 100 100 100 100
100 100 100 100 100 100 100 999 999 999 999 999 999 999 999 999 999 999 999 999 999 999 999 999 999 999 999 999 999 999 999 100 100 100 100 100 100 100 100 100
100 100 100 100 100 100 100 999 999 999 999 324 999 999 999 324 999 999 999 324 999 999 999 324 999 999 999 999 999 999 999 100 100 100 100 100 100 100 100 100
100 100 100 100 100 100 100 4101 999 999 999 999 999 999 999 999 999 999 999 999 999 999 999 999 999 999 999 4100 999 999 999 100 100 100 100 100 100 100 100 100
100 100 100 100 100 100 100 999 999 5100 999 999 999 999 999 601 999 999 999 603 999 999 999 999 999 5400 999 999 999 999 999 100 100 100 100 100 100 100 100 100
100 100 100 100 100 100 100 999 999 999 999 999 999 999 999 999 999 999 999 999 999 999 999 999 999 999 999 999 999 999 999 100 100 100 100 100 100 100 100 100
100 100 100 100 100 100 100 999 999 999 999 999 999 999 999 999 999 999 999 999 999 999 999 999 999 999 999 999 999 999 999 100 100 100 100 100 100 100 100 100
100 100 100 100 100 100 100 999 999 999 999 999 999 999 999 999 999 999 999 999 999 999 999 999 999 999 999 999 999 999 999 100 100 100 100 100 100 100 100 100
100 100 100 100 100 100 100 100 100 100 100 100 100 100 100 100 100 106 999 999 999 100 100 100 100 100 100 100 100 100 100 100 100 100 100 100 100 100 100 100
100 100 100 100 100 100 100 100 100 100 100 100 100 100 100 100 100 999 802 999 999 100 100 100 100 100 100 100 100 100 100 100 100 100 100 100 100 100 100 100
100 100 100 100 100 100 100 100 100 100 100 100 100 100 100 100 100 999 999 999 999 100 100 100 100 100 100 100 100 100 100 100 100 100 100 100 100 100 100 100
100 100 100 100 100 100 100 100 100 100 100 100 100 100 100 100 100 999 999 999 999 100 100 100 100 100 100 100 100 100 100 100 100 100 100 100 100 100 100 100
100 100 100 100 100 100 100 100 100 100 100 100 100 100 100 100 100 100 100 100 100 100 100 100 100 100 100 100 100 100 100 100 100 100 100 100 100 100 100 100
100 100 100 100 100 100 100 100 100 100 100 100 100 100 100 100 100 100 100 100 100 100 100 100 100 100 100 100 100 100 100 100 100 100 100 100 100 100 100 100
room2.txt
NONE
jukebox_room.txt
NONE
