100 100 100 100 100 100 100 100 100 100 100 100 100 100 100 100 100 100 100 100 100 100 100 100 100 100 100 100 100 100 100 100 100 100 100 100 100 100 100 100 
100 100 100 100 100 100 100 100 100 100 100 100 100 100 100 100 100 100 100 100 100 100 100 100 100 100 100 100 100 100 100 100 100 100 100 100 100 100 100 100 
100 100 100 100 100 100 100 100 100 100 100 100 100 100 100 100 100 106 800 992 992 100 100 100 100 100 100 100 100 100 100 100 100 100 100 100 100 100 100 100 
100 100 100 100 100 100 100 100 100 100 100 100 100 100 100 100 100 992 992 992 992 100 100 100 100 100 100 100 100 100 100 100 100 100 100 100 100 100 100 100 
100 100 100 100 100 100 100 100 100 100 100 100 100 100 100 100 100 992 992 992 992 100 100 100 100 100 100 100 100 100 100 100 100 100 100 100 100 100 100 100 
100 100 100 100 100 100 100 100 100 100 100 100 100 100 100 100 100 992 992 992 992 100 100 100 100 100 100 100 100 100 100 100 100 100 100 100 100 100 100 100 
100 100 100 100 100 100 100 100 100 100 100 100 100 100 100 100 100 4401 992 992 992 100 100 100 100 100 100 100 100 100 100 100 100 100 100 100 100 100 100 100 
100 100 100 100 100 100 100 100 100 100 100 100 100 100 100 100 100 4001 992 992 992 100 100 100 100 100 100 100 100 100 100 100 100 100 100 100 100 100 100 100 
100 100 100 100 100 100 100 100 100 100 100 100 100 100 100 100 100 4101 992 992 992 100 100 100 100 100 100 100 100 100 100 100 100 100 100 100 100 100 100 100 
100 100 100 100 100 100 100 100 100 100 100 100 100 100 100 100 100 4301 992 992 992 100 100 100 100 100 100 100 100 100 100 100 100 100 100 100 100 100 100 100 
100 100 100 100 100 100 100 107 992 992 992 992 992 992 992 4310 106 992 992 106 992 992 4311 107 992 992 992 992 992 992 992 100 100 100 100 100 100 100 100 100 
100 100 100 100 100 100 100 992 992 992 992 992 992 992 992 992 992 992 992 992 992 992 992 992 992 992 992 992 992 992 992 100 100 100 100 100 100 100 100 100 
100 100 100 100 100 100 100 992 992 5000 992 992 992 992 992 992 992 992 992 992 992 992 992 992 992 5300 992 992 992 992 992 100 100 100 100 100 100 100 100 100 
100 100 100 100 100 100 100 992 992 992 992 992 992 992 992 992 992 992 992 992 992 992 992 992 992 992 992 992 992 992 992 100 100 100 100 100 100 100 100 100 
100 100 100 100 100 100 100 992 992 992 992 992 992 992 992 100 100 100 100 100 100 100 100 992 992 992 992 992 992 992 992 100 100 100 100 100 100 100 100 100 
100 100 100 100 100 100 100 992 992 992 992 992 992 992 992 100 100 100 100 100 100 100 100 992 992 992 992 992 992 992 992 100 100 100 100 100 100 100 100 100 
100 100 100 100 100 100 100 992 992 992 992 992 992 992 992 100 100 100 100 100 100 100 100 992 992 992 992 992 992 992 992 100 100 100 100 100 100 100 100 100 
100 100 100 100 100 100 100 992 992 992 992 992 992 992 992 100 100 100 100 100 100 100 100 992 992 992 992 992 992 992 992 100 100 100 100 100 100 100 100 100 
100 100 100 100 100 100 100 107 992 992 992 992 992 992 992 100 100 100 100 100 100 100 100 107 992 992 992 992 992 992 992 100 100 100 100 100 100 100 100 100 
100 100 100 100 100 100 100 992 992 992 992 992 992 992 992 100 100 100 100 100 100 100 100 992 992 992 992 992 992 992 992 100 100 100 100 100 100 100 100 100 
100 100 100 100 100 100 100 324 222 222 222 4301 992 992 992 100 100 100 100 100 100 100 100 4300 992 992 992 324 222 222 222 100 100 100 100 100 100 100 100 100 
100 100 100 100 100 100 100 222 222 222 222 4001 992 992 992 100 100 100 100 100 100 100 100 4001 992 992 992 222 222 222 222 100 100 100 100 100 100 100 100 100 
100 100 100 100 100 100 100 992 992 992 992 5400 992 992 992 5300 992 992 992 5100 992 992 992 5000 992 992 992 992 992 992 992 100 100 100 100 100 100 100 100 100 
100 100 100 100 100 100 100 992 992 992 992 992 992 992 992 992 992 992 992 992 992 992 992 992 992 992 992 992 992 992 992 100 100 100 100 100 100 100 100 100 
100 100 100 100 100 100 100 992 992 992 992 992 992 992 992 992 992 992 992 992 992 992 992 992 992 992 992 992 992 992 992 100 100 100 100 100 100 100 100 100 
100 100 100 100 100 100 100 992 992 992 992 992 992 992 992 992 992 992 992 992 992 992 992 992 992 992 992 992 992 992 992 100 100 100 100 100 100 100 100 100 
100 100 100 100 100 100 100 107 992 992 992 992 992 992 992 107 992 992 992 992 992 992 992 107 992 992 992 992 992 992 992 100 100 100 100 100 100 100 100 100 
100 100 100 100 100 100 100 992 992 992 992 992 992 992 992 992 992 992 992 992 992 992 992 992 992 992 992 992 992 992 992 100 100 100 100 100 100 100 100 100 
100 100 100 100 100 100 100 992 992 992 992 324 222 222 222 324 222 222 222 324 222 222 222 324 222 222 222 992 992 992 992 100 100 100 100 100 100 100 100 100 
100 100 100 100 100 100 100 4101 992 992 992 222 222 222 222 222 222 222 222 222 222 222 222 222 222 222 222 4100 992 992 992 100 100 100 100 100 100 100 100 100 
100 100 100 100 100 100 100 992 992 5100 992 992 992 992 992 611 992 992 992 631 992 992 992 992 992 5400 992 992 992 992 992 100 100 100 100 100 100 100 100 100 
100 100 100 100 100 100 100 992 992 992 992 992 992 992 992 992 992 992 992 992 992 992 992 992 992 992 992 992 992 992 992 100 100 100 100 100 100 100 100 100 
100 100 100 100 100 100 100 992 992 992 992 992 992 992 992 992 992 992 992 992 992 992 992 992 992 992 992 992 992 992 992 100 100 100 100 100 100 100 100 100 
100 100 100 100 100 100 100 992 992 992 992 992 992 992 992 992 992 992 992 992 992 992 992 992 992 992 992 992 992 992 992 100 100 100 100 100 100 100 100 100 
100 100 100 100 100 100 100 100 100 100 100 100 100 100 100 100 100 106 992 992 992 100 100 100 100 100 100 100 100 100 100 100 100 100 100 100 100 100 100 100 
100 100 100 100 100 100 100 100 100 100 100 100 100 100 100 100 100 992 802 992 992 100 100 100 100 100 100 100 100 100 100 100 100 100 100 100 100 100 100 100 
100 100 100 100 100 100 100 100 100 100 100 100 100 100 100 100 100 992 992 992 992 100 100 100 100 100 100 100 100 100 100 100 100 100 100 100 100 100 100 100 
100 100 100 100 100 100 100 100 100 100 100 100 100 100 100 100 100 992 992 992 992 100 100 100 100 100 100 100 100 100 100 100 100 100 100 100 100 100 100 100 
100 100 100 100 100 100 100 100 100 100 100 100 100 100 100 100 100 100 100 100 100 100 100 100 100 100 100 100 100 100 100 100 100 100 100 100 100 100 100 100 
100 100 100 100 100 100 100 100 100 100 100 100 100 100 100 100 100 100 100 100 100 100 100 100 100 100 100 100 100 100 100 100 100 100 100 100 100 100 100 100 
room2.txt
NONE
jukebox_room.txt
NONE
