00 00 00 00 00 00 00 00 00 00 00 00 00 00 00 00 00 00 00 00 00 00 00 00 00 00 00 00 00 00 00 00 00 00 00 00 00 00 00 00
00 00 00 00 00 00 00 00 00 00 00 00 00 00 00 00 00 00 00 00 00 00 00 00 00 00 00 00 00 00 00 00 00 00 00 00 00 00 00 00
00 00 00 00 00 00 00 00 00 00 00 00 00 00 00 00 00 06 21 99 99 00 00 00 00 00 00 00 00 00 00 00 00 00 00 00 00 00 00 00
00 00 00 00 00 00 00 00 00 00 00 00 00 00 00 00 00 99 99 99 99 00 00 00 00 00 00 00 00 00 00 00 00 00 00 00 00 00 00 00
00 00 00 00 00 00 00 00 00 00 00 00 00 00 00 00 00 99 99 99 99 00 00 00 00 00 00 00 00 00 00 00 00 00 00 00 00 00 00 00
00 00 00 00 00 00 00 00 00 00 00 00 00 00 00 00 00 99 99 99 99 00 00 00 00 00 00 00 00 00 00 00 00 00 00 00 00 00 00 00
00 00 00 00 00 00 00 00 00 00 00 00 00 00 00 00 00 40 99 99 99 00 00 00 00 00 00 00 00 00 00 00 00 00 00 00 00 00 00 00
00 00 00 00 00 00 00 00 00 00 00 00 00 00 00 00 00 41 99 99 99 00 00 00 00 00 00 00 00 00 00 00 00 00 00 00 00 00 00 00
00 00 00 00 00 00 00 00 00 00 00 00 00 00 00 00 00 47 99 99 99 00 00 00 00 00 00 00 00 00 00 00 00 00 00 00 00 00 00 00
00 00 00 00 00 00 00 00 00 00 00 00 00 00 00 00 00 43 99 99 99 00 00 00 00 00 00 00 00 00 00 00 00 00 00 00 00 00 00 00
00 00 00 00 00 00 00 07 99 99 99 99 99 99 99 45 06 99 99 06 99 99 44 07 99 99 99 99 99 99 99 00 00 00 00 00 00 00 00 00
00 00 00 00 00 00 00 99 99 99 99 99 99 99 99 99 99 99 99 99 99 99 99 99 99 99 99 99 99 99 99 00 00 00 00 00 00 00 00 00
00 00 00 00 00 00 00 99 99 31 99 99 99 99 99 99 99 99 99 99 99 99 99 99 99 33 99 99 99 99 99 00 00 00 00 00 00 00 00 00
00 00 00 00 00 00 00 99 99 99 99 99 99 99 99 99 99 99 99 99 99 99 99 99 99 99 99 99 99 99 99 00 00 00 00 00 00 00 00 00
00 00 00 00 00 00 00 99 99 99 99 99 99 99 99 00 00 00 00 00 00 00 00 99 99 99 99 99 99 99 99 00 00 00 00 00 00 00 00 00
00 00 00 00 00 00 00 99 99 99 99 99 99 99 99 00 00 00 00 00 00 00 00 99 99 99 99 99 99 99 99 00 00 00 00 00 00 00 00 00
00 00 00 00 00 00 00 99 99 99 99 99 99 99 99 00 00 00 00 00 00 00 00 99 99 99 99 99 99 99 99 00 00 00 00 00 00 00 00 00
00 00 00 00 00 00 00 99 99 99 99 99 99 99 99 00 00 00 00 00 00 00 00 99 99 99 99 99 99 99 99 00 00 00 00 00 00 00 00 00
00 00 00 00 00 00 00 06 99 99 99 06 99 99 99 00 00 00 00 00 00 00 00 06 99 99 99 06 99 99 99 00 00 00 00 00 00 00 00 00
00 00 00 00 00 00 00 99 99 99 99 99 99 99 99 00 00 00 00 00 00 00 00 99 99 99 99 99 99 99 99 00 00 00 00 00 00 00 00 00
00 00 00 00 00 00 00 08 99 99 99 43 99 99 99 00 00 00 00 00 00 00 00 46 99 99 99 08 99 99 99 00 00 00 00 00 00 00 00 00
00 00 00 00 00 00 00 99 99 99 99 41 99 99 99 00 00 00 00 00 00 00 00 41 99 99 99 99 99 99 99 00 00 00 00 00 00 00 00 00
00 00 00 00 00 00 00 06 99 99 99 34 99 99 99 37 99 99 99 36 99 99 99 35 99 99 99 06 99 99 99 00 00 00 00 00 00 00 00 00
00 00 00 00 00 00 00 99 99 99 99 99 99 99 99 99 99 99 99 99 99 99 99 99 99 99 99 99 99 99 99 00 00 00 00 00 00 00 00 00
00 00 00 00 00 00 00 99 99 99 99 99 99 99 99 99 99 99 99 99 99 99 99 99 99 99 99 99 99 99 99 00 00 00 00 00 00 00 00 00
00 00 00 00 00 00 00 99 99 99 99 99 99 99 99 99 99 99 99 99 99 99 99 99 99 99 99 99 99 99 99 00 00 00 00 00 00 00 00 00
00 00 00 00 00 00 00 06 99 99 99 99 99 99 99 99 99 99 99 99 99 99 99 99 99 99 99 06 99 99 99 00 00 00 00 00 00 00 00 00
00 00 00 00 00 00 00 99 99 99 99 99 99 99 99 99 99 99 99 99 99 99 99 99 99 99 99 99 99 99 99 00 00 00 00 00 00 00 00 00
00 00 00 00 00 00 00 99 99 99 99 08 99 99 99 08 99 99 99 08 99 99 99 08 99 99 99 99 99 99 99 00 00 00 00 00 00 00 00 00
00 00 00 00 00 00 00 47 99 99 99 99 99 99 99 99 99 99 99 99 99 99 99 99 99 99 99 42 99 99 99 00 00 00 00 00 00 00 00 00
00 00 00 00 00 00 00 09 99 32 99 99 99 09 99 10 99 99 99 10 99 99 99 09 99 30 99 99 99 09 99 00 00 00 00 00 00 00 00 00
00 00 00 00 00 00 00 99 99 99 99 99 99 99 99 99 99 99 99 99 99 99 99 99 99 99 99 99 99 99 99 00 00 00 00 00 00 00 00 00
00 00 00 00 00 00 00 99 99 99 99 99 99 99 99 99 99 99 99 99 99 99 99 99 99 99 99 99 99 99 99 00 00 00 00 00 00 00 00 00
00 00 00 00 00 00 00 99 99 99 99 99 99 99 99 99 99 99 99 99 99 99 99 99 99 99 99 99 99 99 99 00 00 00 00 00 00 00 00 00
00 00 00 00 00 00 00 00 00 00 00 00 00 00 00 00 00 06 99 99 99 00 00 00 00 00 00 00 00 00 00 00 00 00 00 00 00 00 00 00
00 00 00 00 00 00 00 00 00 00 00 00 00 00 00 00 00 99 21 99 99 00 00 00 00 00 00 00 00 00 00 00 00 00 00 00 00 00 00 00
00 00 00 00 00 00 00 00 00 00 00 00 00 00 00 00 00 99 99 99 99 00 00 00 00 00 00 00 00 00 00 00 00 00 00 00 00 00 00 00
00 00 00 00 00 00 00 00 00 00 00 00 00 00 00 00 00 99 99 99 99 00 00 00 00 00 00 00 00 00 00 00 00 00 00 00 00 00 00 00
00 00 00 00 00 00 00 00 00 00 00 00 00 00 00 00 00 00 00 00 00 00 00 00 00 00 00 00 00 00 00 00 00 00 00 00 00 00 00 00
00 00 00 00 00 00 00 00 00 00 00 00 00 00 00 00 00 00 00 00 00 00 00 00 00 00 00 00 00 00 00 00 00 00 00 00 00 00 00 00
