100 100 100 100 100 100 100 100 100 100 100 100 100 100 100 100 100 100 100 100 100 100 100 100 100 100 100 100 100 100 100 100 100 100 100 100 100 100 100 100 
100 100 100 100 100 100 100 100 100 100 100 100 100 100 100 100 100 100 100 100 100 100 100 100 100 100 100 100 100 100 100 100 100 100 100 100 100 100 100 100 
100 100 100 100 100 100 100 100 100 100 100 100 100 100 100 100 100 106 800 999 999 100 100 100 100 100 100 100 100 100 100 100 100 100 100 100 100 100 100 100 
100 100 100 100 100 100 100 100 100 100 100 100 100 100 100 100 100 999 999 999 999 100 100 100 100 100 100 100 100 100 100 100 100 100 100 100 100 100 100 100 
100 100 100 100 100 100 100 100 100 100 100 100 100 100 100 100 100 999 999 999 999 100 100 100 100 100 100 100 100 100 100 100 100 100 100 100 100 100 100 100 
100 100 100 100 100 100 100 100 100 100 100 100 100 100 100 100 100 999 999 999 999 100 100 100 100 100 100 100 100 100 100 100 100 100 100 100 100 100 100 100 
100 100 100 100 100 100 100 100 100 100 100 100 100 100 100 100 100 4401 222 222 222 100 100 100 100 100 100 100 100 100 100 100 100 100 100 100 100 100 100 100 
100 100 100 100 100 100 100 100 100 100 100 100 100 100 100 100 100 4001 222 222 222 100 100 100 100 100 100 100 100 100 100 100 100 100 100 100 100 100 100 100 
100 100 100 100 100 100 100 100 100 100 100 100 100 100 100 100 100 4101 222 222 222 100 100 100 100 100 100 100 100 100 100 100 100 100 100 100 100 100 100 100 
100 100 100 100 100 100 100 100 100 100 100 100 100 100 100 100 100 4301 222 222 222 100 100 100 100 100 100 100 100 100 100 100 100 100 100 100 100 100 100 100 
100 100 100 100 100 100 100 107 999 999 999 999 999 999 999 4310 106 999 999 106 999 999 4311 107 999 999 999 999 999 999 999 100 100 100 100 100 100 100 100 100 
100 100 100 100 100 100 100 999 999 999 999 999 999 999 999 999 999 999 999 999 999 999 222 999 999 999 999 999 999 999 999 100 100 100 100 100 100 100 100 100 
100 100 100 100 100 100 100 999 999 5000 999 999 999 999 999 999 999 999 999 999 999 999 222 999 999 5300 999 999 999 999 999 100 100 100 100 100 100 100 100 100 
100 100 100 100 100 100 100 999 999 999 999 999 999 999 999 999 999 999 999 999 999 999 222 999 999 999 999 999 999 999 999 100 100 100 100 100 100 100 100 100 
100 100 100 100 100 100 100 999 999 999 999 999 999 999 999 100 100 100 100 100 100 100 100 999 999 999 999 999 999 999 999 100 100 100 100 100 100 100 100 100 
100 100 100 100 100 100 100 999 999 999 999 999 999 999 999 100 100 100 100 100 100 100 100 999 999 999 999 999 999 999 999 100 100 100 100 100 100 100 100 100 
100 100 100 100 100 100 100 999 999 999 999 999 999 999 999 100 100 100 100 100 100 100 100 999 999 999 999 999 999 999 999 100 100 100 100 100 100 100 100 100 
100 100 100 100 100 100 100 999 999 999 999 999 999 999 999 100 100 100 100 100 100 100 100 999 999 999 999 999 999 999 999 100 100 100 100 100 100 100 100 100 
100 100 100 100 100 100 100 107 999 999 999 999 999 999 999 100 100 100 100 100 100 100 100 107 999 999 999 999 999 999 999 100 100 100 100 100 100 100 100 100 
100 100 100 100 100 100 100 999 999 999 999 999 999 999 999 100 100 100 100 100 100 100 100 999 999 999 999 999 999 999 999 100 100 100 100 100 100 100 100 100 
100 100 100 100 100 100 100 324 222 222 222 4301 222 222 222 100 100 100 100 100 100 100 100 4300 999 999 999 324 222 222 222 100 100 100 100 100 100 100 100 100 
100 100 100 100 100 100 100 222 222 222 222 4001 222 222 222 100 100 100 100 100 100 100 100 4001 222 222 222 222 222 222 222 100 100 100 100 100 100 100 100 100 
100 100 100 100 100 100 100 999 999 999 999 107 999 999 999 999 999 999 999 107 999 999 999 999 999 999 999 999 999 999 999 100 100 100 100 100 100 100 100 100 
100 100 100 100 100 100 100 999 999 999 999 5400 999 999 999 5300 999 999 999 5100 999 999 999 5000 999 999 999 999 999 999 999 100 100 100 100 100 100 100 100 100 
100 100 100 100 100 100 100 999 999 999 999 999 999 999 999 999 999 999 999 999 999 999 999 999 999 999 999 999 999 999 999 100 100 100 100 100 100 100 100 100 
100 100 100 100 100 100 100 999 999 999 999 999 999 999 999 999 999 999 999 999 999 999 999 999 999 999 999 999 999 999 999 100 100 100 100 100 100 100 100 100 
100 100 100 100 100 100 100 106 999 999 999 999 999 999 999 999 999 999 999 999 999 999 999 999 999 999 999 106 999 999 999 100 100 100 100 100 100 100 100 100 
100 100 100 100 100 100 100 999 999 999 999 999 999 999 999 108 999 999 999 108 999 999 999 999 999 999 999 999 999 999 999 100 100 100 100 100 100 100 100 100 
100 100 100 100 100 100 100 999 999 999 999 324 222 222 222 324 222 222 222 324 9222 222 222 324 222 222 222 999 999 999 999 100 100 100 100 100 100 100 100 100 
100 100 100 100 100 100 100 4101 222 222 222 222 222 222 222 222 222 222 222 222 222 222 222 222 222 222 222 4100 999 999 999 100 100 100 100 100 100 100 100 100 
100 100 100 100 100 100 100 109 999 5100 999 999 999 999 999 611 999 999 106 999 631 999 999 109 999 5400 999 999 999 999 999 100 100 100 100 100 100 100 100 100 
100 100 100 100 100 100 100 999 999 999 999 999 999 999 999 999 999 999 999 999 999 999 999 999 999 999 999 999 999 999 999 100 100 100 100 100 100 100 100 100 
100 100 100 100 100 100 100 999 999 999 999 999 999 999 999 999 999 999 999 999 999 999 999 999 999 999 999 999 999 999 999 100 100 100 100 100 100 100 100 100 
100 100 100 100 100 100 100 999 999 999 999 999 999 999 999 999 999 999 999 999 999 999 999 999 999 999 999 999 999 999 999 100 100 100 100 100 100 100 100 100 
100 100 100 100 100 100 100 100 100 100 100 100 100 100 100 100 100 106 999 999 999 100 100 100 100 100 100 100 100 100 100 100 100 100 100 100 100 100 100 100 
100 100 100 100 100 100 100 100 100 100 100 100 100 100 100 100 100 999 802 999 999 100 100 100 100 100 100 100 100 100 100 100 100 100 100 100 100 100 100 100 
100 100 100 100 100 100 100 100 100 100 100 100 100 100 100 100 100 999 999 999 999 100 100 100 100 100 100 100 100 100 100 100 100 100 100 100 100 100 100 100 
100 100 100 100 100 100 100 100 100 100 100 100 100 100 100 100 100 999 999 999 999 100 100 100 100 100 100 100 100 100 100 100 100 100 100 100 100 100 100 100 
100 100 100 100 100 100 100 100 100 100 100 100 100 100 100 100 100 100 100 100 100 100 100 100 100 100 100 100 100 100 100 100 100 100 100 100 100 100 100 100 
100 100 100 100 100 100 100 100 100 100 100 100 100 100 100 100 100 100 100 100 100 100 100 100 100 100 100 100 100 100 100 100 100 100 100 100 100 100 100 100 
room2.txt
none
jukebox_room.txt
none
