100 100 100 100 100 100 100 100 100 100 100 100 100 100 100 100 100 100 100 100 100 100 100 100 100 100 100 100 100 100 100 100 100 100 100 100 100 100 100 100 
100 100 100 100 100 100 100 100 100 100 100 100 100 100 100 100 100 100 100 100 100 100 100 100 100 100 100 100 100 100 100 100 100 100 100 100 100 100 100 100 
100 100 100 100 100 100 100 100 100 100 100 100 100 100 100 100 100 100 100 100 100 100 100 100 100 100 100 100 100 100 100 100 100 100 100 100 100 100 100 100 
100 100 100 100 100 100 100 100 100 100 100 100 100 100 100 100 100 100 100 100 100 100 100 100 100 100 100 100 100 100 100 100 100 100 100 100 100 100 100 100 
100 100 100 100 100 100 100 100 100 100 100 100 100 100 100 100 100 100 100 100 100 100 100 100 100 100 100 100 100 100 100 100 100 100 100 100 100 100 100 100 
100 100 100 100 100 100 100 100 100 100 100 100 100 100 100 100 100 100 100 100 100 100 100 100 100 100 100 100 100 100 100 100 100 100 100 100 100 100 100 100 
100 100 100 100 100 100 100 100 100 100 100 100 100 100 100 100 100 100 100 100 100 100 100 100 100 100 100 100 100 100 100 100 100 100 100 100 100 100 100 100 
100 100 100 100 100 100 100 100 100 100 100 100 100 100 100 100 100 100 100 100 100 100 100 100 100 100 100 100 100 100 100 100 100 100 100 100 100 100 100 100 
100 100 100 100 100 100 100 100 100 100 100 100 105 800 999 999 100 100 100 100 100 100 100 100 100 100 100 100 100 100 100 100 100 100 100 100 100 100 100 100 
100 100 100 100 100 100 100 100 100 100 100 100 999 999 999 999 100 100 100 100 100 100 100 100 100 100 100 100 100 100 100 100 100 100 100 100 100 100 100 100 
100 100 100 100 100 100 100 100 100 100 100 100 999 999 999 999 100 100 100 100 100 100 100 100 100 100 100 100 100 100 100 100 100 100 100 100 100 100 100 100 
100 100 100 100 100 100 100 100 100 100 100 100 999 999 999 999 100 100 100 100 100 100 100 100 100 100 100 100 100 100 100 100 100 100 100 100 100 100 100 100 
100 100 100 100 100 100 100 100 105 999 999 999 105 999 999 999 321 315 222 222 222 222 321 105 105 999 999 999 105 999 999 999 100 100 100 100 100 100 100 100 
100 100 100 100 100 100 100 100 801 999 999 999 999 999 999 999 222 105 105 999 999 999 222 999 999 999 999 999 999 999 999 999 100 100 100 100 100 100 100 100 
100 100 100 100 100 100 100 100 999 999 999 999 999 999 999 999 4311 999 999 999 999 999 4211 999 999 999 910 999 999 999 999 999 100 100 100 100 100 100 100 100 
100 100 100 100 100 100 100 100 999 999 999 999 999 999 999 999 222 999 999 999 999 999 222 999 999 999 999 999 999 999 999 999 100 100 100 100 100 100 100 100 
100 100 100 100 100 100 100 100 105 999 999 999 105 999 999 999 222 999 999 999 999 999 222 105 105 999 999 999 105 999 999 999 100 100 100 100 100 100 100 100 
100 100 100 100 100 100 100 100 999 999 999 999 999 999 999 999 222 321 4401 222 222 222 321 999 999 999 999 999 999 999 999 999 100 100 100 100 100 100 100 100 
100 100 100 100 100 100 100 100 319 222 222 222 222 222 222 222 222 222 4101 222 222 222 222 319 222 222 222 222 222 222 222 222 100 100 100 100 100 100 100 100 
100 100 100 100 100 100 100 100 5110 999 999 999 105 999 999 999 700 105 999 999 105 999 999 700 5310 999 999 999 5410 999 999 999 100 100 100 100 100 100 100 100 
100 100 100 100 100 100 100 100 999 999 999 999 999 999 999 999 999 105 999 105 999 999 999 999 999 999 999 999 999 999 999 999 100 100 100 100 100 100 100 100 
100 100 100 100 100 100 100 100 999 999 999 999 999 999 999 999 999 999 999 999 999 999 999 999 999 999 999 999 999 999 999 999 100 100 100 100 100 100 100 100 
100 100 100 100 100 100 100 100 999 999 999 999 999 999 999 999 331 999 999 999 999 999 999 321 999 999 999 999 999 999 999 999 100 100 100 100 100 100 100 100 
100 100 100 100 100 100 100 100 318 222 222 222 222 222 222 222 222 999 999 999 999 999 999 222 318 222 222 222 222 222 222 222 100 100 100 100 100 100 100 100 
100 100 100 100 100 100 100 100 5410 999 999 999 5210 999 999 999 222 105 999 999 105 999 999 311 105 999 999 999 5110 999 999 999 100 100 100 100 100 100 100 100 
100 100 100 100 100 100 100 100 999 999 999 999 999 999 999 999 700 999 999 999 999 999 999 700 999 999 999 999 999 999 999 999 100 100 100 100 100 100 100 100 
100 100 100 100 100 100 100 100 999 999 999 999 999 999 999 999 999 999 999 999 999 999 999 999 999 999 999 999 999 999 999 999 100 100 100 100 100 100 100 100 
100 100 100 100 100 100 100 100 999 999 999 999 999 999 999 999 999 999 999 999 999 999 999 999 999 999 999 999 999 999 999 999 100 100 100 100 100 100 100 100 
100 100 100 100 100 100 100 100 319 222 222 222 222 222 222 222 222 112 999 999 999 999 999 319 222 222 222 222 222 222 222 222 100 100 100 100 100 100 100 100 
100 100 100 100 100 100 100 100 105 999 999 999 105 999 999 999 111 999 999 802 999 999 999 999 105 999 999 999 105 999 999 999 100 100 100 100 100 100 100 100 
100 100 100 100 100 100 100 100 999 999 999 999 999 999 999 999 999 999 999 999 999 999 999 999 999 999 999 999 999 999 999 999 100 100 100 100 100 100 100 100 
100 100 100 100 100 100 100 100 999 999 999 999 999 999 999 999 999 999 999 999 999 999 999 999 999 999 999 999 999 999 999 999 100 100 100 100 100 100 100 100 
100 100 100 100 100 100 100 100 100 100 100 100 100 100 100 100 100 100 100 100 100 100 100 100 100 100 100 100 100 100 100 100 100 100 100 100 100 100 100 100 
100 100 100 100 100 100 100 100 100 100 100 100 100 100 100 100 100 100 100 100 100 100 100 100 100 100 100 100 100 100 100 100 100 100 100 100 100 100 100 100 
100 100 100 100 100 100 100 100 100 100 100 100 100 100 100 100 100 100 100 100 100 100 100 100 100 100 100 100 100 100 100 100 100 100 100 100 100 100 100 100 
100 100 100 100 100 100 100 100 100 100 100 100 100 100 100 100 100 100 100 100 100 100 100 100 100 100 100 100 100 100 100 100 100 100 100 100 100 100 100 100 
100 100 100 100 100 100 100 100 100 100 100 100 100 100 100 100 100 100 100 100 100 100 100 100 100 100 100 100 100 100 100 100 100 100 100 100 100 100 100 100 
100 100 100 100 100 100 100 100 100 100 100 100 100 100 100 100 100 100 100 100 100 100 100 100 100 100 100 100 100 100 100 100 100 100 100 100 100 100 100 100 
100 100 100 100 100 100 100 100 100 100 100 100 100 100 100 100 100 100 100 100 100 100 100 100 100 100 100 100 100 100 100 100 100 100 100 100 100 100 100 100 
100 100 100 100 100 100 100 100 100 100 100 100 100 100 100 100 100 100 100 100 100 100 100 100 100 100 100 100 100 100 100 100 100 100 100 100 100 100 100 100 
room2.txt
room2.txt
room1.txt
none
